111111111111111
1P00C0001111111
10111110G0C1111
1G0C0G001101111
10111010C00C0C1
10C00C00G0111E1
111111111111111