1111111
1P00G01
11111C1
1C1C1G1
1G1G101
1G101G1
10CG001
1G11111
10GGGE1
1111111