111111111111111111111111111111111111111
1P0000000000000000000000000000000000001
101111101000100111001000101000100111101
100010001000101000101100101001001000001
1C0010001111101111101010101110000111001
100010001000101000101001101001000001101
100010001000101000101000101000101111001
1E0000000000000000000000000000000000001
111111111111111111111111111111111111111
100000000000000000000000000000000000001
100000000001111001000101111100000000001
100000000001000100101001000000000000001
100000000001111000010001111100000000001
100000000001000100010001000000000000001
100000000001111000010001111100000000001
100000000000000000000000000000000000001
111111111111111111111111111111111111111