11111111111111111111111111111111111111111111111111
1P00G0GG0G00GGG0G00GGG0GG00GG0G0GGG0G0GG0G0G0G0GG1
111111111111111111111111111111111111111111111111C1
1E0GGGGGG000GG0G00GGG00G0000G0G0G0G00G0G00G00G0001
11111111111111111111111111111111111111111111111111