1111111111111111111111111111
1000C100000000000000001C0001
1011110111111111111110111101
100G000000000000000000G00001
1011110110111111110110111101
1011110110111111110110111101
10000001100001100001100000G1
1111110111110110111110111111
1111110111110110111110111111
1111110100000000000010111111
11111101G1111111111010111111
11111100000E1P010G000G111111
1111111101111001111111111111
111111C10000000000001C111111
1111110101111111111010111111
100000G0000001100G0000000001
1011110111110110111110111101
1011110111110110111110111101
100011000G00000000000G110001
1010110110111111110110110101
1010110110111111110110110101
10C0000110000C00000110000C01
1111111111111111111111111111
1010101011111111111111111111
1111111111111111111111111111