1111111111111111111111111111111111
1000000000000000000000000000000001
10P000000000000000000000000C000001
1000000000110000010000000000000001
1000011100000000001100000000000001
1000011100000C0000010000000C000001
1000011100000100000000000000000001
1000001110010011011000000001100001
100000000000001GGG1000000000000111
1000C00C0000001GEG1000001000000001
100000000000001GGG10000010000C0001
1110000000100011111000000000000001
1000001000010000001C00000000000001
1C00001100000001000011100C00000001
1000001100000000000111100000000001
100000000000C0001111111000000C0001
1100C00000000000000000000001100011
1000000C00000000000111100000000001
100000000000000000000000C00000C001
1111111111111111111111111111111111