111111111111111
1P00C00011110E1
1111111G1111G11
100C0G001111G11
10111111100C0G1
10C00GG0G0111C1
111111111111111